addendum : addenda
alga : algae
alumna : alumnae
alumnus : alumni
analysis : analyses
antenna : antennas
apparatus : apparatuses
appendix : appendixes
axis : axes
bacillus : bacilli
bacterium : bacteria
basis : bases
beau : beaux
bison : bison
buffalo : buffaloes
bureau : bureaus
bus : buses
cactus : cactuses
calf : calves
child : children
corp : corps
corpus : corpuses
crisis : crises
criterion : criteria
curriculum : curricula
datum : data
deer : deer
die : dice
dwarf : dwarfs
diagnosis : diagnoses
echo : echoes
elf : elves
ellipsis : ellipses
embargo : embargoes
emphasis : emphases
erratum : errata
fireman : firemen
fish : fishes
focus : focuses
foot : feet
formula : formulas
fungus : funguses
genus : genera
goose : geese
half : halves
hero : heroes
hippopotamus : hippopotami
hoof : hooves
hypothesis : hypotheses
index : indexes
knife : knives
leaf : leaves
life : lives
loaf : loaves
louse : lice
man : men
matrix : matrices
means : means
medium : media
memorandum : memoranda
millennium : millennia
moose : moose
mosquito : mosquitoes
mouse : mice
nebula : nebulae
neurosis : neuroses
nucleus : nuclei
oasis : oases
octopus : octopi
ovum : ova
ox : oxen
paralysis : paralyses
parenthesis : parentheses
person : people
phenomenon : phenomena
potato : potatoes
radius : radii
scarf : scarves
self : selves
series : series
sheep : sheep
shelf : shelves
scissors : scissors
species : species
stimulus : stimuli
stratum : strata
syllabus : syllabi
symposium : symposia
synthesis : syntheses
synopsis : synopses
tableau : tableaux
that : those
thesis : theses
thief : thieves
this : these
tomato : tomatoes
tooth : teeth
torpedo : torpedoes
vertebra : vertebrae
veto : vetoes
vita : vitae
watch : watches
wife : wives
wolf : wolves
woman : women
zero : zeroes
